{
  "width": 20,
  "height": 20,
  "tiles": [
    4, 4, 5, 0, 0, 0, 0, 0, 20, 41, 36, 30, 5, 4, 4, 6, 0, 0, 0, 0, 4, 6, 3, 3,
    3, 0, 0, 20, 41, 25, 29, 149, 0, 6, 4, 0, 0, 20, 24, 24, 5, 3, 3, 3, 0, 0,
    20, 41, 25, 36, 30, 0, 0, 2, 0, 20, 24, 41, 25, 25, 6, 3, 3, 1, 0, 20, 41,
    25, 36, 30, 0, 0, 0, 0, 0, 21, 25, 25, 25, 25, 0, 0, 149, 0, 20, 41, 25, 25,
    29, 0, 149, 0, 0, 20, 24, 41, 25, 25, 25, 25, 0, 0, 0, 20, 41, 25, 25, 36,
    30, 0, 0, 149, 94, 41, 25, 25, 25, 25, 25, 25, 24, 24, 24, 41, 25, 67, 36,
    30, 0, 0, 2, 0, 73, 25, 25, 25, 25, 67, 25, 25, 25, 25, 25, 25, 36, 26, 30,
    0, 2, 3, 3, 0, 74, 25, 25, 25, 25, 25, 25, 25, 26, 26, 26, 26, 30, 0, 7, 10,
    10, 10, 15, 0, 21, 25, 25, 36, 26, 26, 25, 25, 10, 10, 10, 10, 10, 10, 17,
    0, 149, 0, 14, 20, 41, 25, 36, 96, 0, 4, 21, 25, 0, 0, 0, 149, 0, 0, 0, 20,
    24, 24, 19, 41, 25, 25, 29, 149, 0, 173, 21, 25, 27, 27, 27, 62, 24, 24, 24,
    41, 25, 25, 19, 25, 25, 25, 37, 97, 0, 6, 21, 25, 0, 0, 0, 22, 26, 26, 116,
    26, 76, 80, 19, 84, 40, 25, 25, 37, 24, 24, 41, 25, 149, 149, 0, 2, 0, 0,
    117, 0, 0, 0, 14, 0, 22, 40, 25, 67, 25, 25, 25, 25, 0, 2, 0, 0, 5, 0, 117,
    0, 2, 0, 9, 15, 0, 22, 40, 25, 25, 25, 25, 25, 0, 0, 5, 3, 5, 3, 117, 5,
    149, 2, 0, 14, 0, 0, 21, 25, 25, 25, 25, 25, 0, 124, 0, 2, 3, 0, 106, 112,
    5, 0, 2, 14, 0, 0, 22, 40, 25, 25, 67, 25, 0, 156, 5, 3, 0, 0, 155, 117, 0,
    5, 0, 14, 0, 0, 161, 22, 40, 25, 25, 25, 10, 10, 10, 10, 10, 11, 10, 18, 10,
    10, 10, 17, 2, 0, 149, 0, 22, 40, 25, 25, 0, 0, 0, 0, 0, 14, 0, 117, 0, 2,
    3, 0, 0, 0, 0, 0, 0, 21, 25, 25
  ],
  "units": [
    { "type": "INFANTRY", "position": { "x": 8, "y": 8 }, "player": "0" },
    { "type": "INFANTRY", "position": { "x": 10, "y": 15 }, "player": "1" }
  ]
}
